111111111111111111111111
10000000M000000M00000001
10000C1000111111000M0001
101111100000000100000001
101C10000000011100000001
10000000001001010C000001
10001C100000001100000001
10001010000000111P100001
10000000M0100000000C0001
1000000E0010011100000001
100000000000000M000000C1
111111111111111111111111
